"Team","Name","Characters","Wins","Losses","Draws","Total Played","Win %","Score","Last Match"
"","Mittens","","140","9","0","149","93","4422","09/01/2015 10:36:47 PM"
"","Alphicans","","152","17","0","169","89","4071","09/01/2015 10:36:47 PM"
"","Quaff","","102","27","0","129","79","3786","09/01/2015 10:36:47 PM"
"","SubzeroKing","","64","17","0","81","79","3753","09/01/2015 10:36:47 PM"
"","Sleak","","74","21","0","95","77","3652","09/01/2015 10:36:47 PM"
"","AozoraX","","98","28","0","126","77","3639","03/01/2015 12:00:00 AM"
"","Superboom","","19","2","0","21","90","3581","21/12/2014 12:00:00 AM"
"","Mach5","","88","24","0","112","78","3562","09/01/2015 10:36:47 PM"
"","Bread","","87","26","0","113","76","3532","09/01/2015 10:36:47 PM"
"","JesusStevo","","36","10","0","46","78","3461","04/12/2014 12:00:00 AM"
"","Crusayer","","199","62","0","261","76","3458","09/01/2015 10:36:47 PM"
"","Dragonz","","48","20","0","68","70","3271","04/12/2014 12:00:00 AM"
"","Victra","","182","68","0","250","72","3253","09/01/2015 10:36:47 PM"
"","Yardsale","","180","94","0","274","65","3100","09/01/2015 12:00:00 AM"
"","Limeee","","97","51","0","148","65","3006","04/01/2015 3:08:17 PM"
"","Anjo","","174","89","0","263","66","3005","09/01/2015 10:36:47 PM"
"","lee","","12","7","0","19","63","2974","04/12/2014 12:00:00 AM"
"","Sega","","145","92","0","237","61","2933","04/01/2015 3:08:17 PM"
"","Zigzagoon","","41","20","0","61","67","2907","04/12/2014 12:00:00 AM"
"","Klash","","32","16","0","48","66","2888","04/12/2014 12:00:00 AM"
"","Skin Flakes","","37","25","0","62","59","2818","21/12/2014 12:00:00 AM"
"","Odds","","48","31","0","79","60","2728","09/01/2015 10:36:47 PM"
"","Booshk","","9","2","0","11","81","2715","04/12/2014 12:00:00 AM"
"","Crook","","36","15","0","51","70","2697","09/01/2015 10:36:47 PM"
"","Face","","59","47","0","106","55","2696","04/01/2015 3:08:17 PM"
"","Lights","","28","17","0","45","62","2687","04/12/2014 12:00:00 AM"
"","Ennbeard","","29","18","0","47","61","2673","04/12/2014 12:00:00 AM"
"","After Dawn","","18","10","0","28","64","2666","04/12/2014 12:00:00 AM"
"","Scythe","","69","42","0","111","62","2593","21/12/2014 12:00:00 AM"
"","Nugs","","113","98","0","211","53","2568","09/01/2015 10:36:47 PM"
"","TIGER-COOL","","10","4","0","14","71","2562","04/12/2014 12:00:00 AM"
"","DertyMike","","23","15","0","38","60","2560","03/01/2015 12:00:00 AM"
"","Vash","","9","3","0","12","75","2519","21/12/2014 12:00:00 AM"
"","BlueZone","","28","18","0","46","60","2506","21/12/2014 12:00:00 AM"
"","Henry","","28","20","0","48","58","2459","05/12/2014 12:00:00 AM"
"","JredL","","7","3","0","10","70","2447","04/12/2014 12:00:00 AM"
"","Espard","","25","17","0","42","59","2431","09/01/2015 12:00:00 AM"
"","Bryan T","","36","27","0","63","57","2416","09/01/2015 12:00:00 AM"
"","Ecchi","","68","45","0","113","60","2410","05/12/2014 12:00:00 AM"
"","Okada","","35","21","0","56","62","2408","06/12/2014 12:00:00 AM"
"","CSH","","59","43","0","102","57","2401","03/01/2015 12:00:00 AM"
"","HongKongDisco","","70","57","0","127","55","2392","21/12/2014 12:00:00 AM"
"","Yoshiii6","","58","56","0","114","50","2337","04/01/2015 12:00:00 AM"
"","Starman","","23","20","0","43","53","2335","09/01/2015 10:36:47 PM"
"","Isaac","","59","42","0","101","58","2321","21/12/2014 12:00:00 AM"
"","Ashley","","44","39","0","83","53","2283","09/01/2015 10:36:47 PM"
"","Frio","","25","19","0","44","56","2282","04/12/2014 12:00:00 AM"
"","Kuraudo","","35","26","0","61","57","2260","09/01/2015 12:00:00 AM"
"","JV","","72","52","0","124","58","2252","04/01/2015 3:08:17 PM"
"","GhillieGuide","","34","33","0","67","50","2241","04/12/2014 12:00:00 AM"
"","Aletheia","","80","81","0","161","49","2235","09/01/2015 12:00:00 AM"
"","PL4YER","","38","21","0","59","64","2235","04/12/2014 12:00:00 AM"
"","Sraigux","","30","26","0","56","53","2227","05/12/2014 12:00:00 AM"
"","Teal","","56","35","0","91","61","2219","04/01/2015 3:08:17 PM"
"","T-Block","","25","15","0","40","62","2219","04/12/2014 12:00:00 AM"
"","Jarrod","","5","1","0","6","83","2215","04/12/2014 12:00:00 AM"
"","RTS Victa","","15","14","0","29","51","2203","04/12/2014 12:00:00 AM"
"","Goro","","36","29","0","65","55","2192","04/12/2014 12:00:00 AM"
"","Tea","","39","44","0","83","46","2188","09/01/2015 10:36:47 PM"
"","TheGroose","","23","21","0","44","52","2187","04/12/2014 12:00:00 AM"
"","Bbro","","24","14","0","38","63","2166","21/12/2014 12:00:00 AM"
"","Jraff","","33","26","0","59","55","2165","04/12/2014 12:00:00 AM"
"","Lezarre","","19","12","0","31","61","2155","04/12/2014 12:00:00 AM"
"","DEW","","28","22","0","50","56","2143","05/12/2014 12:00:00 AM"
"","DMA","","8","7","0","15","53","2100","04/12/2014 12:00:00 AM"
"","Pelican","","26","25","0","51","50","2080","04/01/2015 3:08:17 PM"
"","Krizski","","40","42","0","82","48","2069","09/01/2015 12:00:00 AM"
"","Arkaik","","29","38","0","67","43","2066","04/12/2014 12:00:00 AM"
"","Vinny P","","23","22","0","45","51","2063","04/01/2015 3:08:17 PM"
"","Mr.Green","","24","21","0","45","53","2046","04/12/2014 12:00:00 AM"
"","Gerbii","","28","27","0","55","50","2040","04/12/2014 12:00:00 AM"
"","Raptor","","42","46","0","88","47","2029","04/01/2015 3:08:17 PM"
"","Starkiller","","5","6","0","11","45","1989","04/12/2014 12:00:00 AM"
"","Ark","","28","22","0","50","56","1985","04/12/2014 12:00:00 AM"
"","Matrix","","6","2","0","8","75","1968","04/12/2014 12:00:00 AM"
"","Hub","","17","13","0","30","56","1968","04/12/2014 12:00:00 AM"
"","BrningPyre","","44","51","0","95","46","1942","21/12/2014 12:00:00 AM"
"","Punch Crew Aaron","","10","4","0","14","71","1941","04/12/2014 12:00:00 AM"
"","HeavyRoy","","21","10","0","31","67","1940","06/12/2014 12:00:00 AM"
"","Dlink","","10","14","0","24","41","1884","04/12/2014 12:00:00 AM"
"","Rubix","","42","49","0","91","46","1884","04/01/2015 3:08:17 PM"
"","Neri","","14","22","0","36","38","1857","04/01/2015 3:08:17 PM"
"","Exodus","","41","44","0","85","48","1831","09/01/2015 12:00:00 AM"
"","MagnuM","","7","7","0","14","50","1822","04/12/2014 12:00:00 AM"
"","Comet","","9","10","0","19","47","1812","04/12/2014 12:00:00 AM"
"","Dr. Drew","","5","3","0","8","62","1808","04/12/2014 12:00:00 AM"
"","Taste","","9","8","0","17","52","1787","04/12/2014 12:00:00 AM"
"","Fletch","","15","12","0","27","55","1781","04/12/2014 12:00:00 AM"
"","Weathercock","","12","13","0","25","48","1779","04/12/2014 12:00:00 AM"
"","LemonLau","","5","8","0","13","38","1774","04/12/2014 12:00:00 AM"
"","Silent J","","4","3","0","7","57","1769","04/12/2014 12:00:00 AM"
"","Yojimbo","","32","41","0","73","43","1736","09/01/2015 12:00:00 AM"
"","Drunken Archon","","15","9","0","24","62","1718","04/12/2014 12:00:00 AM"
"","MikeMonkey","","2","5","0","7","28","1713","04/12/2014 12:00:00 AM"
"","Kai","","2","2","0","4","50","1697","04/12/2014 12:00:00 AM"
"","Trung","","6","1","0","7","85","1691","04/12/2014 12:00:00 AM"
"","Yaphet","","30","23","0","53","56","1689","05/12/2014 12:00:00 AM"
"","Bananas","","45","65","0","110","40","1680","04/01/2015 3:08:17 PM"
"","FarHAM","","21","37","0","58","36","1637","04/12/2014 12:00:00 AM"
"","Frozen","","25","24","0","49","51","1634","21/12/2014 12:00:00 AM"
"","JKrizzle","","9","9","0","18","50","1623","04/12/2014 12:00:00 AM"
"","Xero","","4","4","0","8","50","1617","04/12/2014 12:00:00 AM"
"","Terrorbyte","","25","41","0","66","37","1615","04/12/2014 12:00:00 AM"
"","Donneykong","","12","15","0","27","44","1595","21/12/2014 12:00:00 AM"
"","Washtackles","","12","17","0","29","41","1591","04/12/2014 12:00:00 AM"
"","AnthonyK","","6","2","0","8","75","1585","04/12/2014 12:00:00 AM"
"","Annu","","27","37","0","64","42","1573","21/12/2014 12:00:00 AM"
"","Cameronom","","13","17","0","30","43","1566","04/12/2014 12:00:00 AM"
"","SlipnSlide","","10","14","0","24","41","1540","21/12/2014 12:00:00 AM"
"","Macho","","21","32","0","53","39","1515","21/12/2014 12:00:00 AM"
"","Broken","","21","26","0","47","44","1511","05/12/2014 12:00:00 AM"
"","On2","","10","4","0","14","71","1507","04/12/2014 12:00:00 AM"
"","Momo","","11","14","0","25","44","1480","04/12/2014 12:00:00 AM"
"","UnrealOdin","","10","18","0","28","35","1479","09/01/2015 12:00:00 AM"
"","Two Guys in One","","8","8","0","16","50","1470","04/12/2014 12:00:00 AM"
"","Omni","","16","21","0","37","43","1465","04/12/2014 12:00:00 AM"
"","Lon","","11","18","0","29","37","1449","04/12/2014 12:00:00 AM"
"","Holliday","","8","10","0","18","44","1446","04/12/2014 12:00:00 AM"
"","Arson","","8","9","0","17","47","1443","04/12/2014 12:00:00 AM"
"","Fedex","","12","15","0","27","44","1413","04/12/2014 12:00:00 AM"
"","SilentJ","","9","13","0","22","40","1413","04/12/2014 12:00:00 AM"
"","Midnight Maveric","","2","2","0","4","50","1412","04/12/2014 12:00:00 AM"
"","Hexagon","","12","19","0","31","38","1404","04/12/2014 12:00:00 AM"
"","NexusFlip","","8","20","0","28","28","1402","03/01/2015 12:00:00 AM"
"","Savy eh?","","12","18","0","30","40","1387","04/12/2014 12:00:00 AM"
"","Yoshara","","26","55","0","81","32","1385","04/12/2014 12:00:00 AM"
"","CeOuNerd","","14","31","0","45","31","1373","04/12/2014 12:00:00 AM"
"","Borz","","19","38","0","57","33","1372","09/01/2015 12:00:00 AM"
"","Lilseph","","8","14","0","22","36","1361","04/12/2014 12:00:00 AM"
"","C-lusion","","8","9","0","17","47","1359","04/12/2014 12:00:00 AM"
"","Geenareeno","","4","4","0","8","50","1358","21/12/2014 12:00:00 AM"
"","YellowBob0","","10","23","0","33","30","1353","09/01/2015 12:00:00 AM"
"","Mike Chau","","3","4","0","7","42","1350","04/12/2014 12:00:00 AM"
"","Mo","","2","2","0","4","50","1336","04/12/2014 12:00:00 AM"
"","PV","","5","7","0","12","41","1334","04/12/2014 12:00:00 AM"
"","FTW","","5","4","0","9","55","1333","04/12/2014 12:00:00 AM"
"","Jara","","8","17","0","25","32","1329","04/12/2014 12:00:00 AM"
"","DaSupaLuis","","2","4","0","6","33","1312","04/12/2014 12:00:00 AM"
"","Deez","","8","15","0","23","34","1305","21/12/2014 12:00:00 AM"
"","Merv","","3","4","0","7","42","1304","04/12/2014 12:00:00 AM"
"","Bast","","5","8","0","13","38","1301","09/01/2015 12:00:00 AM"
"","Xerox","","28","44","0","72","38","1276","05/12/2014 12:00:00 AM"
"","Mouse","","5","4","0","9","55","1270","04/12/2014 12:00:00 AM"
"","Kieu","","7","8","0","15","46","1242","04/12/2014 12:00:00 AM"
"","Semicolon","","4","6","0","10","40","1241","04/12/2014 12:00:00 AM"
"","CrimsonBeast","","12","17","0","29","41","1239","21/12/2014 12:00:00 AM"
"","Afro","","6","12","0","18","33","1236","06/12/2014 12:00:00 AM"
"","Konnar","","3","4","0","7","42","1228","04/12/2014 12:00:00 AM"
"","Omicron","","7","11","0","18","38","1215","04/12/2014 12:00:00 AM"
"","SDK","","25","45","0","70","35","1213","04/01/2015 3:08:17 PM"
"","kgAo","","16","24","0","40","40","1201","04/12/2014 12:00:00 AM"
"","Salsa","","29","71","0","100","29","1195","21/12/2014 12:00:00 AM"
"","Dookie","","3","1","0","4","75","1182","04/12/2014 12:00:00 AM"
"","Kull","","15","26","0","41","36","1180","21/12/2014 12:00:00 AM"
"","Bxxrams","","11","22","0","33","33","1177","04/12/2014 12:00:00 AM"
"","Hype","","9","21","0","30","30","1163","04/12/2014 12:00:00 AM"
"","Johnknee","","6","5","0","11","54","1137","04/12/2014 12:00:00 AM"
"","Scimitar","","4","6","0","10","40","1135","04/12/2014 12:00:00 AM"
"","JRK","","2","2","0","4","50","1123","04/12/2014 12:00:00 AM"
"","Qwuv","","5","6","0","11","45","1121","04/12/2014 12:00:00 AM"
"","MattP","","3","2","0","5","60","1113","04/12/2014 12:00:00 AM"
"","Lopez","","7","22","0","29","24","1113","04/12/2014 12:00:00 AM"
"","RyanH","","3","6","0","9","33","1091","04/12/2014 12:00:00 AM"
"","Khillasaurus","","22","52","0","74","29","1089","04/01/2015 3:08:17 PM"
"","RawCloudZero","","9","13","0","22","40","1089","04/12/2014 12:00:00 AM"
"","NeonBlack","","3","4","0","7","42","1087","04/12/2014 12:00:00 AM"
"","Wamsa","","5","14","0","19","26","1083","09/01/2015 12:00:00 AM"
"","ThisIs","","4","1","0","5","80","1079","04/12/2014 12:00:00 AM"
"","Brebz","","3","4","0","7","42","1072","05/12/2014 12:00:00 AM"
"","DLES","","2","8","0","10","20","1069","04/12/2014 12:00:00 AM"
"","Jomzy","","3","13","0","16","18","1067","04/12/2014 12:00:00 AM"
"","Tim To","","5","9","0","14","35","1060","04/12/2014 12:00:00 AM"
"","Vile","","3","8","0","11","27","1058","04/12/2014 12:00:00 AM"
"","Ivan","","2","5","0","7","28","1042","04/12/2014 12:00:00 AM"
"","Escalator Boy","","5","9","0","14","35","1036","04/12/2014 12:00:00 AM"
"","Nicka","","14","38","0","52","26","1033","05/12/2014 12:00:00 AM"
"","N","","11","31","0","42","26","1028","04/01/2015 3:08:17 PM"
"","mtagstyle","","3","6","0","9","33","1023","04/12/2014 12:00:00 AM"
"","SwiggitySwooty","","8","16","0","24","33","1019","04/01/2015 3:08:17 PM"
"","Fruitsations","","5","14","0","19","26","1018","04/12/2014 12:00:00 AM"
"","Tank","","2","6","0","8","25","1015","04/12/2014 12:00:00 AM"
"","Whist","","4","3","0","7","57","1015","04/12/2014 12:00:00 AM"
"","Desu","","7","15","0","22","31","1004","04/12/2014 12:00:00 AM"
"","Cale","","12","31","0","43","27","1003","04/01/2015 3:08:17 PM"
"","Turbo Scrub","","2","2","0","4","50","996","04/12/2014 12:00:00 AM"
"","Tiger","","6","9","0","15","40","995","04/12/2014 12:00:00 AM"
"","Wolfe","","3","4","0","7","42","992","04/12/2014 12:00:00 AM"
"","Novista","","4","9","0","13","30","986","04/12/2014 12:00:00 AM"
"","ButtNuster","","14","34","0","48","29","972","04/12/2014 12:00:00 AM"
"","Draco","","5","7","0","12","41","971","04/12/2014 12:00:00 AM"
"","Baker","","5","17","0","22","22","966","04/12/2014 12:00:00 AM"
"","Mastodon","","5","15","0","20","25","950","05/12/2014 12:00:00 AM"
"","Cepton","","4","12","0","16","25","945","04/12/2014 12:00:00 AM"
"","BoldPylon","","3","5","0","8","37","942","04/12/2014 12:00:00 AM"
"","QAZ","","3","9","0","12","25","940","04/12/2014 12:00:00 AM"
"","Mr. To","","2","3","0","5","40","935","04/12/2014 12:00:00 AM"
"","Robocop","","1","2","0","3","33","934","04/12/2014 12:00:00 AM"
"","Sketch","","3","4","0","7","42","928","21/12/2014 12:00:00 AM"
"","Fred","","2","3","0","5","40","916","04/12/2014 12:00:00 AM"
"","Jamal","","3","6","0","9","33","902","04/12/2014 12:00:00 AM"
"","Strudel","","8","31","0","39","20","902","09/01/2015 12:00:00 AM"
"","indigo","","2","5","0","7","28","899","04/12/2014 12:00:00 AM"
"","Fosh","","2","2","0","4","50","892","04/12/2014 12:00:00 AM"
"","GreenT","","10","29","0","39","25","891","21/12/2014 12:00:00 AM"
"","JosePonyPants","","4","5","0","9","44","884","04/12/2014 12:00:00 AM"
"","RJM","","3","10","0","13","23","871","04/12/2014 12:00:00 AM"
"","MDMike","","3","4","0","7","42","866","04/12/2014 12:00:00 AM"
"","MonkeyMandibles","","3","4","0","7","42","861","21/12/2014 12:00:00 AM"
"","Kehorie","","5","9","0","14","35","855","21/12/2014 12:00:00 AM"
"","SlayerBoy","","3","3","0","6","50","855","04/01/2015 3:08:17 PM"
"","Kcurb","","8","15","0","23","34","854","21/12/2014 12:00:00 AM"
"","Yzus","","3","6","0","9","33","853","04/12/2014 12:00:00 AM"
"","MikeAruba","","2","3","0","5","40","845","04/12/2014 12:00:00 AM"
"","Dumber child","","2","1","0","3","66","834","04/12/2014 12:00:00 AM"
"","Thread","","2","2","0","4","50","829","05/12/2014 12:00:00 AM"
"","TGD","","6","10","0","16","37","825","04/12/2014 12:00:00 AM"
"","Cody","","2","4","0","6","33","809","04/12/2014 12:00:00 AM"
"","Dr.Nono","","8","31","0","39","20","802","21/12/2014 12:00:00 AM"
"","Nitro","","3","15","0","18","16","800","09/01/2015 12:00:00 AM"
"","Kasko","","2","11","0","13","15","783","04/12/2014 12:00:00 AM"
"","Ping","","2","3","0","5","40","773","04/12/2014 12:00:00 AM"
"","Yam Fries ","","1","2","0","3","33","772","04/12/2014 12:00:00 AM"
"","Progue","","2","4","0","6","33","760","05/12/2014 12:00:00 AM"
"","WoodCocker","","3","10","0","13","23","753","04/12/2014 12:00:00 AM"
"","Pollyllop","","3","5","0","8","37","752","04/01/2015 3:08:17 PM"
"","Will","","2","5","0","7","28","746","04/12/2014 12:00:00 AM"
"","Scrambles","","3","6","0","9","33","743","04/12/2014 12:00:00 AM"
"","Akaio","","6","16","0","22","27","739","04/12/2014 12:00:00 AM"
"","Goonu","","6","19","0","25","24","736","04/12/2014 12:00:00 AM"
"","Maplekid","","3","10","0","13","23","736","04/12/2014 12:00:00 AM"
"","Wagner","","1","2","0","3","33","734","04/12/2014 12:00:00 AM"
"","Lobos","","3","6","0","9","33","733","06/12/2014 12:00:00 AM"
"","Vera","","5","13","0","18","27","730","04/12/2014 12:00:00 AM"
"","Aloof","","2","5","0","7","28","724","04/12/2014 12:00:00 AM"
"","DoctorL","","1","4","0","5","20","719","04/12/2014 12:00:00 AM"
"","Champrodeo","","2","5","0","7","28","718","04/12/2014 12:00:00 AM"
"","The Slayer","","3","3","0","6","50","715","04/12/2014 12:00:00 AM"
"","Jmasters","","1","2","0","3","33","712","04/12/2014 12:00:00 AM"
"","Ben Wiltshire","","2","2","0","4","50","703","04/12/2014 12:00:00 AM"
"","BathTub","","2","2","0","4","50","698","04/12/2014 12:00:00 AM"
"","The Burner Guy","","2","2","0","4","50","685","04/12/2014 12:00:00 AM"
"","Hukster","","2","7","0","9","22","681","04/12/2014 12:00:00 AM"
"","TV","","5","22","0","27","18","679","09/01/2015 12:00:00 AM"
"","Shwee","","2","2","0","4","50","676","04/12/2014 12:00:00 AM"
"","NickFury","","3","22","0","25","12","675","04/12/2014 12:00:00 AM"
"","Mikeismyike","","4","16","0","20","20","672","04/12/2014 12:00:00 AM"
"","Ryan","","1","2","0","3","33","661","04/12/2014 12:00:00 AM"
"","SHRD","","1","2","0","3","33","655","04/12/2014 12:00:00 AM"
"","TopDog","","1","2","0","3","33","654","04/12/2014 12:00:00 AM"
"","Twoft","","3","3","0","6","50","648","04/12/2014 12:00:00 AM"
"","Slivicus","","1","2","0","3","33","643","04/12/2014 12:00:00 AM"
"","True","","2","9","0","11","18","639","04/12/2014 12:00:00 AM"
"","GallantTigger","","1","2","0","3","33","632","04/12/2014 12:00:00 AM"
"","Wiebe","","4","11","0","15","26","624","04/12/2014 12:00:00 AM"
"","Pieguy","","2","3","0","5","40","618","04/12/2014 12:00:00 AM"
"","PrinceLolo","","2","14","0","16","12","614","04/12/2014 12:00:00 AM"
"","Vypex","","1","4","0","5","20","609","21/12/2014 12:00:00 AM"
"","DoctorMan","","3","13","0","16","18","606","04/12/2014 12:00:00 AM"
"","VerticallyChallenged","","1","6","0","7","14","595","04/12/2014 12:00:00 AM"
"","Keil","","4","17","0","21","19","591","04/12/2014 12:00:00 AM"
"","SpecV","","1","2","0","3","33","589","04/12/2014 12:00:00 AM"
"","Slowmo","","2","12","0","14","14","575","04/12/2014 12:00:00 AM"
"","Bane","","1","2","0","3","33","562","04/12/2014 12:00:00 AM"
"","Jam","","2","4","0","6","33","561","04/12/2014 12:00:00 AM"
"","Muffchasm","","2","7","0","9","22","559","21/12/2014 12:00:00 AM"
"","220","","1","6","0","7","14","551","21/12/2014 12:00:00 AM"
"","Peanutts!","","1","7","0","8","12","545","09/01/2015 12:00:00 AM"
"","DeadM","","1","2","0","3","33","542","04/12/2014 12:00:00 AM"
"","PoppinFresh","","2","11","0","13","15","537","09/01/2015 12:00:00 AM"
"","Riceykins","","1","2","0","3","33","530","04/12/2014 12:00:00 AM"
"","Taco","","2","9","0","11","18","523","04/12/2014 12:00:00 AM"
"","Fraser","","1","6","0","7","14","516","04/12/2014 12:00:00 AM"
"","dny","","1","2","0","3","33","514","04/12/2014 12:00:00 AM"
"","NBZ","","1","5","0","6","16","514","04/12/2014 12:00:00 AM"
"","Cheet","","3","2","0","5","60","512","04/12/2014 12:00:00 AM"
"","SamW","","3","11","0","14","21","506","04/12/2014 12:00:00 AM"
"","Moonrobin","","2","12","0","14","14","505","04/12/2014 12:00:00 AM"
"","Jon","","2","2","0","4","50","505","04/12/2014 12:00:00 AM"
"","Andrew K","","1","4","0","5","20","500","04/12/2014 12:00:00 AM"
"","EscalatorBoy","","1","2","0","3","33","497","04/12/2014 12:00:00 AM"
"","FAN","","2","14","0","16","12","493","09/01/2015 12:00:00 AM"
"","Nicholisk","","1","6","0","7","14","492","04/12/2014 12:00:00 AM"
"","Nefel","","1","2","0","3","33","483","04/12/2014 12:00:00 AM"
"","KrispyKreamer","","1","5","0","6","16","480","04/12/2014 12:00:00 AM"
"","Geisan","","2","6","0","8","25","464","04/12/2014 12:00:00 AM"
"","Zach The Rock","","1","3","0","4","25","457","04/12/2014 12:00:00 AM"
"","TS","","1","7","0","8","12","457","04/12/2014 12:00:00 AM"
"","Jesse","","1","1","0","2","50","445","04/12/2014 12:00:00 AM"
"","Rekt","","1","11","0","12","8","434","21/12/2014 12:00:00 AM"
"","Quack","","1","2","0","3","33","432","04/12/2014 12:00:00 AM"
"","MajoraShyGuy","","1","8","0","9","11","430","03/01/2015 12:00:00 AM"
"","Ganonlink","","1","6","0","7","14","411","04/12/2014 12:00:00 AM"
"","Kard","","1","5","0","6","16","411","04/12/2014 12:00:00 AM"
"","Stetch","","2","4","0","6","33","391","04/12/2014 12:00:00 AM"
"","Jack","","1","5","0","6","16","388","04/12/2014 12:00:00 AM"
"","Hettman","","1","5","0","6","16","381","04/12/2014 12:00:00 AM"
"","Vertex","","1","5","0","6","16","378","04/12/2014 12:00:00 AM"
"","NelsonWiebe","","1","4","0","5","20","364","21/12/2014 12:00:00 AM"
"","ConstableD","","1","6","0","7","14","357","09/01/2015 12:00:00 AM"
"","Crow","","1","5","0","6","16","356","04/12/2014 12:00:00 AM"
"","Dr. Tran","","1","4","0","5","20","327","04/12/2014 12:00:00 AM"
"","That One Guy","","1","7","0","8","12","326","04/12/2014 12:00:00 AM"
"","Keat","","1","9","0","10","10","319","04/12/2014 12:00:00 AM"
"","TaberCorn","","3","16","0","19","15","315","04/12/2014 12:00:00 AM"
"","SkulKra","","1","2","0","3","33","302","04/12/2014 12:00:00 AM"
"","Wang","","2","4","0","6","33","298","04/12/2014 12:00:00 AM"
"","Claus","","1","6","0","7","14","294","04/12/2014 12:00:00 AM"
"","Mason","","1","7","0","8","12","237","04/12/2014 12:00:00 AM"
"","Tiggs","","1","13","0","14","7","237","04/12/2014 12:00:00 AM"
"","SomethingRandom","","1","2","0","3","33","237","04/12/2014 12:00:00 AM"
"","PlatPlat","","1","4","0","5","20","234","21/12/2014 12:00:00 AM"
"","Rain Runner","","1","4","0","5","20","233","21/12/2014 12:00:00 AM"
"","Elias","","2","5","0","7","28","212","04/12/2014 12:00:00 AM"
"","Foolhardy","","1","15","0","16","6","199","04/12/2014 12:00:00 AM"
"","CS","","0","7","0","7","0","187","04/12/2014 12:00:00 AM"
"","Chris","","1","2","0","3","33","183","04/12/2014 12:00:00 AM"
"","Mr. President","","0","2","0","2","0","179","04/12/2014 12:00:00 AM"
"","Calvin Wong","","1","4","0","5","20","177","04/12/2014 12:00:00 AM"
"","Aerous","","0","2","0","2","0","176","04/12/2014 12:00:00 AM"
"","Bonkinator","","1","2","0","3","33","174","04/12/2014 12:00:00 AM"
"","Prism","","2","13","0","15","13","173","04/12/2014 12:00:00 AM"
"","Mish","","0","4","0","4","0","164","04/12/2014 12:00:00 AM"
"","BoxSalt","","0","8","0","8","0","147","09/01/2015 12:00:00 AM"
"","Spunky","","0","6","0","6","0","145","04/12/2014 12:00:00 AM"
"","ill","","0","6","0","6","0","145","03/01/2015 12:00:00 AM"
"","Churly","","0","2","0","2","0","130","04/12/2014 12:00:00 AM"
"","JonMac","","0","8","0","8","0","130","09/01/2015 12:00:00 AM"
"","Big K.O. ","","0","5","0","5","0","129","04/12/2014 12:00:00 AM"
"","Zap","","1","7","0","8","12","128","04/12/2014 12:00:00 AM"
"","TPar","","0","5","0","5","0","124","04/12/2014 12:00:00 AM"
"","Passive","","0","2","0","2","0","122","04/12/2014 12:00:00 AM"
"","CPU","","0","2","0","2","0","120","04/12/2014 12:00:00 AM"
"","Pyrite","","1","7","0","8","12","118","04/12/2014 12:00:00 AM"
"","backtrackker","","0","2","0","2","0","108","04/12/2014 12:00:00 AM"
"","Laobao","","1","2","0","3","33","94","04/12/2014 12:00:00 AM"
"","mac attack","","0","2","0","2","0","92","04/12/2014 12:00:00 AM"
"","Trig","","0","2","0","2","0","91","04/12/2014 12:00:00 AM"
"","Deef","","0","5","0","5","0","90","04/12/2014 12:00:00 AM"
"","xemasklyr","","0","4","0","4","0","84","04/12/2014 12:00:00 AM"
"","Apex","","0","6","0","6","0","75","04/12/2014 12:00:00 AM"
"","Binky","","1","4","0","5","20","74","04/12/2014 12:00:00 AM"
"","Boss","","0","7","0","7","0","70","04/12/2014 12:00:00 AM"
"","Madg","","0","2","0","2","0","68","04/12/2014 12:00:00 AM"
"","Captain Cardinal","","1","5","0","6","16","64","04/12/2014 12:00:00 AM"
"","Ghost","","0","4","0","4","0","63","04/12/2014 12:00:00 AM"
"","Chewi","","0","9","0","9","0","63","05/12/2014 12:00:00 AM"
"","Kelvin","","1","9","0","10","10","60","21/12/2014 12:00:00 AM"
"","jason","","0","2","0","2","0","51","04/12/2014 12:00:00 AM"
"","Groose","","0","6","0","6","0","50","04/12/2014 12:00:00 AM"
"","J-Rod","","1","4","0","5","20","48","04/12/2014 12:00:00 AM"
"","Paracolor","","0","2","0","2","0","46","04/12/2014 12:00:00 AM"
"","Latromi","","3","38","0","41","7","45","05/12/2014 12:00:00 AM"
"","MrDoCut","","0","2","0","2","0","42","04/12/2014 12:00:00 AM"
"","Explosive Ghosts","","0","7","0","7","0","39","04/12/2014 12:00:00 AM"
"","Arial Hawk","","0","2","0","2","0","39","04/12/2014 12:00:00 AM"
"","SeanB","","1","5","0","6","16","38","04/12/2014 12:00:00 AM"
"","Lan","","0","2","0","2","0","33","04/12/2014 12:00:00 AM"
"","RaidenUKE","","0","6","0","6","0","20","04/12/2014 12:00:00 AM"
"","Scott","","0","3","0","3","0","14","04/12/2014 12:00:00 AM"
"","Crimes","","0","2","0","2","0","10","04/12/2014 12:00:00 AM"
"","Adam","","0","5","0","5","0","9","04/12/2014 12:00:00 AM"
"","Rise Above","","0","6","0","6","0","7","04/12/2014 12:00:00 AM"
"","Morm","","1","2","0","3","33","1","04/12/2014 12:00:00 AM"
"","Ant","","0","3","0","3","0","0","04/12/2014 12:00:00 AM"
"","Stuv","","0","5","0","5","0","0","21/12/2014 12:00:00 AM"
"","Jimbro","","0","5","0","5","0","0","21/12/2014 12:00:00 AM"
"","Masterblaster","","1","3","0","4","25","0","05/12/2014 12:00:00 AM"
"","Ghoul","","0","6","0","6","0","0","04/12/2014 12:00:00 AM"
"","SpaceRanger91","","1","8","0","9","11","0","04/12/2014 12:00:00 AM"
"","CruX","","0","6","0","6","0","0","04/12/2014 12:00:00 AM"
"","Hawk","","0","4","0","4","0","0","04/12/2014 12:00:00 AM"
"","Dank","","0","8","0","8","0","0","04/12/2014 12:00:00 AM"
"","Mr. BLT","","0","2","0","2","0","0","04/12/2014 12:00:00 AM"
"","Luffy","","0","1","0","1","0","0","04/12/2014 12:00:00 AM"
"","Extra1","","0","0","0","0","0","0","01/01/0001 12:00:00 AM"
"","Extra3","","0","0","0","0","0","0","01/01/0001 12:00:00 AM"
"","Vecktor","","0","2","0","2","0","0","04/12/2014 12:00:00 AM"
"","Dongler","","0","2","0","2","0","0","04/12/2014 12:00:00 AM"
"","MICH","","0","2","0","2","0","0","04/12/2014 12:00:00 AM"
"","Zeastau","","0","2","0","2","0","0","04/12/2014 12:00:00 AM"
"","RedSkyHypnosis","","0","2","0","2","0","0","04/12/2014 12:00:00 AM"
"","Odat","","0","2","0","2","0","0","04/12/2014 12:00:00 AM"
"","Popplestone","","0","2","0","2","0","0","04/12/2014 12:00:00 AM"
"","Piers","","0","6","0","6","0","0","04/12/2014 12:00:00 AM"
"","YungBlud","","0","6","0","6","0","0","04/12/2014 12:00:00 AM"
"","pop","","0","7","0","7","0","0","04/12/2014 12:00:00 AM"
"","Diaz","","0","2","0","2","0","0","04/12/2014 12:00:00 AM"
"","Thai","","0","5","0","5","0","0","04/12/2014 12:00:00 AM"
"","Caramel","","0","2","0","2","0","0","04/12/2014 12:00:00 AM"
"","SRC_CODE","","0","6","0","6","0","0","04/12/2014 12:00:00 AM"
"","Cryo-chill","","0","2","0","2","0","0","04/12/2014 12:00:00 AM"
"","Pitri","","0","4","0","4","0","0","04/12/2014 12:00:00 AM"
"","Hampus","","0","7","0","7","0","0","04/12/2014 12:00:00 AM"
"","Joey R","","0","2","0","2","0","0","04/12/2014 12:00:00 AM"
"","Trangulation","","0","2","0","2","0","0","04/12/2014 12:00:00 AM"
"","CM Punk","","0","2","0","2","0","0","04/12/2014 12:00:00 AM"
"","Sn896","","0","7","0","7","0","0","04/12/2014 12:00:00 AM"
"","Kegwrecker","","0","8","0","8","0","0","04/12/2014 12:00:00 AM"
"","Ritherz","","0","2","0","2","0","0","04/12/2014 12:00:00 AM"
"","DylanLan","","0","4","0","4","0","0","06/12/2014 12:00:00 AM"
"","DV8","","0","4","0","4","0","0","04/12/2014 12:00:00 AM"
"","Coach Lau Senpai","","0","2","0","2","0","0","04/12/2014 12:00:00 AM"
"","Test Subject","","0","10","0","10","0","0","04/12/2014 12:00:00 AM"
"","Alex Shuba","","0","2","0","2","0","0","04/12/2014 12:00:00 AM"
"","Solar","","0","2","0","2","0","0","04/12/2014 12:00:00 AM"
"","Chai","","0","9","0","9","0","0","04/12/2014 12:00:00 AM"
"","Stephano","","0","5","0","5","0","0","04/12/2014 12:00:00 AM"
"","yield","","0","2","0","2","0","0","04/12/2014 12:00:00 AM"
"","BlackEyes","","0","6","0","6","0","0","04/12/2014 12:00:00 AM"
"","Oreo","","0","6","0","6","0","0","04/12/2014 12:00:00 AM"
"","Mormra","","0","2","0","2","0","0","04/12/2014 12:00:00 AM"
"","Lo","","0","6","0","6","0","0","04/12/2014 12:00:00 AM"
"","Ecch","","0","5","0","5","0","0","04/12/2014 12:00:00 AM"
"","Antawn","","0","5","0","5","0","0","04/12/2014 12:00:00 AM"
"","VinceL","","0","7","0","7","0","0","04/12/2014 12:00:00 AM"
"","Double Oh Seven","","0","2","0","2","0","0","04/12/2014 12:00:00 AM"
"","Mark","","0","2","0","2","0","0","04/12/2014 12:00:00 AM"
"","JBJFUN","","0","2","0","2","0","0","04/12/2014 12:00:00 AM"
"","Rania","","0","2","0","2","0","0","04/12/2014 12:00:00 AM"
"","Hareak","","0","4","0","4","0","0","04/12/2014 12:00:00 AM"
"","Blaine","","0","5","0","5","0","0","04/12/2014 12:00:00 AM"
"","Reguls","","0","2","0","2","0","0","04/12/2014 12:00:00 AM"
"","T-REX","","0","7","0","7","0","0","04/12/2014 12:00:00 AM"
"","Leah","","0","2","0","2","0","0","04/12/2014 12:00:00 AM"
"","Kempta","","1","6","0","7","14","0","04/12/2014 12:00:00 AM"
"","Hunnehbuns","","0","7","0","7","0","0","04/12/2014 12:00:00 AM"
"","MultiPlatGamer","","0","5","0","5","0","0","04/12/2014 12:00:00 AM"
"","Corpse","","0","1","0","1","0","0","04/12/2014 12:00:00 AM"
"","Bulby","","0","6","0","6","0","0","04/12/2014 12:00:00 AM"
"","CameronS","","0","6","0","6","0","0","04/12/2014 12:00:00 AM"
"","New Guy","","0","2","0","2","0","0","04/12/2014 12:00:00 AM"
"","Cougar","","0","9","0","9","0","0","04/12/2014 12:00:00 AM"
"","Dan?","","0","4","0","4","0","0","04/12/2014 12:00:00 AM"
"","AWildStaryu","","0","2","0","2","0","0","04/12/2014 12:00:00 AM"
"","Sterling","","0","5","0","5","0","0","21/12/2014 12:00:00 AM"
"","I suck at this game","","0","5","0","5","0","0","21/12/2014 12:00:00 AM"
"","SBZ Kill","","0","5","0","5","0","0","21/12/2014 12:00:00 AM"
"","Superloli","","0","2","0","2","0","0","06/12/2014 12:00:00 AM"
